XXXXXXXXXX
X..X.....X
X....XX..X
XX.X..X..X
X..XXXX.XX
X.1X..X..X
X..X.XXGXX
XXG11..P.X
X...X..X.X
XXXXXXXXXX