XXXXXXXXXX
X..X.....X
X....XX..X
XX.X..X..X
X..XXXX.XX
X..X..XG.X
X..X.XX.XX
XXG11..P.X
X...X..X.X
XXXXXXXXXX