XXXXXXXXXX
X..XG....X
X...1XX.GX
XX.X..X..X
X..XX1X.XX
XX.X..X..X
X..X1XX.XX
XX.11X.P.X
X......X.X
XXXXXXXXXX