XXXXXXXXXX
X..X.....X
X....XX.GX
XX.X..X..X
X..XX.X.XX
X..X..XG.X
X..X.XX.XX
XX.11X.P.X
X......X.X
XXXXXXXXXX