XXXXXXXXXX
X..X....GX
X1..1XX.GX
XX1X..X..X
X..XX1X.XX
XX.X..X..X
X..X1XX.XX
XX.11X.P.X
X...1..X.X
XXXXXXXXXX